RRRRRRRRR
RGGGMGGGR
SGOBMGGGE
RGGGGBBYR
RRRRRRRRR
